5
4
12
10
0100000000000
0100111100000
0101100100000
0100000100000
0111111111100
0010100101000
0010000100000
0111101100000
0000000111000
0000000000000
